Michael Jackson's This Is It	Columbia Pictures
All the King's Men	Columbia Pictures
To Sir, with Love	Columbia Pictures
Guess Who's Coming to Dinner	Columbia Pictures
Taxi Driver	Columbia Pictures
Close Encounters of the Third Kind	Columbia Pictures
Ghostbusters	Columbia Pictures
The Karate Kid	Columbia Pictures
Spider-Man	Columbia Pictures
Men in Black	Columbia Pictures
Bad Boys	Columbia Pictures
James Bond series	Eon Productions
The Ten Commandments	Paramount Pictures
Vertigo	Paramount Pictures
Rosemary's Baby	Paramount Pictures
The Odd Couple	Paramount Pictures
The Godfather	Paramount Pictures
The Bad News Bears	Paramount Pictures
Saturday Night Fever	Paramount Pictures
Beverly Hills Cop	Paramount Pictures
Star Trek	Paramount Pictures
Top Gun	Paramount Pictures
Ghost	Paramount Pictures
Braveheart	Paramount Pictures
Mission: Impossible	Paramount Pictures
Indiana Jones	Paramount Pictures
Forrest Gump	Paramount Pictures
Saving Private Ryan	Paramount Pictures
Transformers	Paramount Pictures
Friday The 13th	Paramount Pictures
Noah	Paramount Pictures
Bright Eyes	20th Century Fox
Son of Fury	20th Century Fox
Home in Indiana	20th Century Fox
Journey to the Center of the Earth	20th Century Fox
The Sound of Music	20th Century Fox
Fantastic Voyage	20th Century Fox
Star Wars	20th Century Fox
X-Men	20th Century Fox
Die Hard	20th Century Fox
Alien	20th Century Fox
Planet of the Apes	20th Century Fox
Home Alone	20th Century Fox
Predator	20th Century Fox
Speed	20th Century Fox
Independence Day	20th Century Fox
Avatar	20th Century Fox
The Simpsons Movie	20th Century Fox
The Wolf Man	Universal Studios
The Mummy	Universal Studios
Spartacus	Universal Studios
Airport	Universal Studios
Jaws	Universal Studios
The Blues Brothers	Universal Studios
The Deer Hunter	Universal Studios
Rollercoaster	Universal Studios
Back to the Future	Universal Studios
Field of Dreams	Universal Studios
Backdraft	Universal Studios
Beethoven	Universal Studios
Dr. Giggles	Universal Studios
Jurassic Park	Universal Studios
Meet the Parents	Universal Studios
The Bourne Identity	Universal Studios
The Sting	Universal Studios
E.T.	Universal Studios
Schindler's List	Universal Studios
Dracula	Universal Studios
Oblivion	Universal Studios
Rush	Universal Studios
