Al Hirschfeld Theatre	Jujamcyn Theaters
Ambassador Theatre	Shubert Organization
American Airlines Theatre	Roundabout Theatre; Company
August Wilson Theatre	Jujamcyn Theaters
Belasco Theatre	Shubert Organization
Bernard B Jacobs Theatre	Shubert Organization
Booth Theatre	Shubert Organization
Broadhurst Theatre	Shubert Organization
Broadway Theatre	Shubert Organization
Brooks Atkinson Theatre	Nederlander Organization
Cadillac Winter Garden Theatre	Shubert Organization
Circle In The Square Theatre	Circle in the Square
Cort Theatre	Shubert Organization
Ethel Barrymore Theatre	Shubert Organization
Gerald Schoenfeld Theatre	Shubert Organization
Gershwin Theatre	Nederlander Organization
Helen Hayes Theatre	Second Stage
Imperial Theatre	Shubert Organization
John Golden Theatre	Shubert Organization
Longacre Theatre	Shubert Organization
Lunt Fontanne Theatre	Nederlander Organization
Lyceum Theatre	Shubert Organization
Lyric Theatre	Clear Channel
Majestic Theatre	Shubert Organization
Marquis Theatre	Nederlander Organization
Minskoff Theatre	Nederlander Organization
Music Box Theatre	Shubert Organization
Nederlander Theatre	Nederlander Organization
Neil Simon Theatre	Nederlander Organization
New Amsterdam Theatre	Disney; Theatrical; Productions
Palace Theatre	Nederlander Organization
Richard Rodgers Theatre	Nederlander Organization
Samuel J Friedman Theatre	Manhattan; Theatre; Club
Shubert Theatre	Shubert Organization
St James Theatre	Jujamcyn Theaters
Vivian Beaumont Theatre	Lincoln Center Theater
Walter Kerr Theatre	Jujamcyn Theaters