Jameis Winston	Florida State
Robert Griffin III	Baylor
Cameron Newton	Auburn
Mark Ingram	Alabama
Sam Bradford	Oklahoma
Tim Tebow	Florida
Troy Smith	Ohio State
Reggie Bush	Southern California
Matt Leinart	Southern California
Jason White	Oklahoma
Carson Palmer	Southern California
Eric Crouch	Nebraska
Chris Weinke	Florida State
Ron Dayne	Wisconsin
Ricky Williams	Texas
Charles Woodson	Michigan
Danny Wuerffel	Florida
Eddie George	Ohio State
Rashaan Salaam	Colorado
Charlie Ward	Florida State
Gino Torretta	Miami
Desmond Howard	Michigan
Ty Detmer	Brigham Young
Andre Ware	Houston
Barry Sanders	Oklahoma State
Tim Brown	Notre Dame
Vinny Testaverde	Miami
Bo Jackson	Auburn
Doug Flutie	Boston College
Mike Rozier	Nebraska
Herschel Walker	Georgia
Marcus Allen	Southern California
George Rogers	South Carolina
Charles White	Southern California
Billy Sims	Oklahoma
Earl Campbell	Texas
Tony Dorsett	Pittsburgh
Archie Griffin	Ohio State
Archie Griffin	Ohio State
John Cappelletti	Penn State
Johnny Rodgers	Nebraska
Pat Sullivan	Auburn
Jim Plunkett	Stanford
Steve Owens	Oklahoma
O.J. Simpson	Southern California
Gary Beban	UCLA
Steve Spurrier	Florida
Mike Garrett	Southern California
John Huarte	Notre Dame
Roger Staubach	Navy
Terry Baker	Oregon State
Ernie Davis	Syracuse
Joe Bellino	Navy
Billy Cannon	LSU
Pete Dawkins	Army
Paul Hornung	Notre Dame
Howard Cassady	Ohio State
Alan Ameche	Wisconsin
Johnny Lattner	Notre Dame
Billy Vessels	Oklahoma
Dick Kazmaier	Princeton
Vic Janowicz	Ohio State
Leon Hart	Notre Dame
Doak Walker	Southern Methodist
Johnny Lujack	Notre Dame
Glenn Davis	Army
Doc Blanchard	Army
Les Horvath	Ohio State
Angelo Bertelli	Notre Dame
Frank Sinkwich	Georgia
Bruce Smith	Minnesota
Tom Harmon	Michigan
Nile Kinnick	Iowa
Clint Frank	Yale
Larry Kelley	Yale
Jay Berwanger	Chicago