Parnate	tranylcypromine
Nardil	phenelzine
Marplan	isocarboxazid
Anafranil	clomipramine
Elavil	amitriptyline
Norpramin	desipramine
Pamelor	nortriptyline
Sinequan	doxepin
Surmontil	trimipramine
Celexa	citalopram
Lexapro	escitalopram
Luvox	fluvoxamine
Paxil	paroxetine
Prozac	fluoxetine
Zoloft	sertraline
Cymbalta	duloxetine
Effexor	venlafaxine
Remeron	mirtazapine
Wellbutrin	bupropion
Desyrel	trazodone