Princess almost there	The Princess and the Frog
Down in New Orleans (Prologue)	The Princess and the Frog
Down in New Orleans	The Princess and the Frog
Almost There	The Princess and the Frog
Friends on the Other Side	The Princess and the Frog
When We're Human	The Princess and the Frog
Gonna Take You There	The Princess and the Frog
Ma Belle Evangeline	The Princess and the Frog
Dig a Little Deeper	The Princess and the Frog
Down in New Orleans (Reprise)	The Princess and the Frog
Fathoms Below	The Little Mermaid and Sequels
Daughters of Triton	The Little Mermaid and Sequels
Part of Your World	The Little Mermaid and Sequels
Part of Your World (Reprise)	The Little Mermaid and Sequels
Under the Sea	The Little Mermaid and Sequels
Poor Unfortunate Souls	The Little Mermaid and Sequels
Kiss the Girl	The Little Mermaid and Sequels
Down to the Sea	The Little Mermaid and Sequels
For a Moment	The Little Mermaid and Sequels
Tip and Dash	The Little Mermaid and Sequels
Land and Sea	The Little Mermaid and Sequels
Athena's Song	The Little Mermaid and Sequels
Just One Mistake	The Little Mermaid and Sequels
Shake, Sanora	The Little Mermaid and Sequels
I Remember	The Little Mermaid and Sequels
Just One Mistake (Reprise)	The Little Mermaid and Sequels
Shake, Sanorra (Reprise)	The Little Mermaid and Sequels
I Will Sing	The Little Mermaid and Sequels
Ballroom	Beauty and the Beast and Sequels
That Belle	Beauty and the Beast and Sequels
That Belle (Reprise)	Beauty and the Beast and Sequels
Gaston (song)	Beauty and the Beast and Sequels
Gaston (Reprise)	Beauty and the Beast and Sequels
Be Our Guest	Beauty and the Beast and Sequels
Something There	Beauty and the Beast and Sequels
Beauty and the Beast	Beauty and the Beast and Sequels
The Mob Song	Beauty and the Beast and Sequels
Beauty and the Beast (Reprise)	Beauty and the Beast and Sequels
A Little Thought	Beauty and the Beast and Sequels
Stories	Beauty and the Beast and Sequels
As Long As There's Christmas	Beauty and the Beast and Sequels
Don't Fall in Love	Beauty and the Beast and Sequels
Arabian Nights	Aladdin and Sequels and TV songs
One Jump Ahead	Aladdin and Sequels and TV songs
Friend Like Me	Aladdin and Sequels and TV songs
Prince Ali	Aladdin and Sequels and TV songs
A Whole New World	Aladdin and Sequels and TV songs
Prince Ali (Reprise)	Aladdin and Sequels and TV songs
A Whole New World (Reprise)	Aladdin and Sequels and TV songs
I'm Looking Out for Me	Aladdin and Sequels and TV songs
Nothing in the World (Quite Like a Friend)	Aladdin and Sequels and TV songs
Forget About Love	Aladdin and Sequels and TV songs
You're Only Second Rate	Aladdin and Sequels and TV songs
There's a Party Here in Agrabah	Aladdin and Sequels and TV songs
There's a Party Here in Agrabah (Reprise)	Aladdin and Sequels and TV songs
Out of Thin Air	Aladdin and Sequels and TV songs
Welcome To The Forty Thieves	Aladdin and Sequels and TV songs
Father and Son	Aladdin and Sequels and TV songs
Are You In or Out	Aladdin and Sequels and TV songs
When Will my Life Begin?	Tangled
Mother Knows Best	Tangled
When Will my Life Begin? (Reprise)	Tangled
I Have a Dream	Tangled
Mother Knows Best (Reprise)	Tangled
I See the Light	Tangled
Healing Incantation	Tangled
A Dream is a Wish Your Heart Makes	Cinderella and Sequels
Sing, Sweet Nightingale	Cinderella and Sequels
The Working Song	Cinderella and Sequels
Bibbidi-Bobbidy-Boo	Cinderella and Sequels
So This is Love	Cinderella and Sequels
Perfectly Perfect	Cinderella and Sequels
More Than a Dream	Cinderella and Sequels
At The Ball	Cinderella and Sequels
I Still Believe	Cinderella and Sequels
I'm Wishing/One Song	Snow White
With a Smile and a Song	Snow White
Whistle While You Work	Snow White
Heigh-Ho	Snow White
The Silly Song	Snow White
Someday My Prince Will Come	Snow White
The Virginia Company	Pocahontas and Sequel
Steady as the Beating Drum	Pocahontas and Sequel
Just Around the Riverbend	Pocahontas and Sequel
Listen With Your Heart	Pocahontas and Sequel
Mine, Mine, Mine	Pocahontas and Sequel
Colors of the Wind	Pocahontas and Sequel
If I Never Knew You	Pocahontas and Sequel
Savages	Pocahontas and Sequel
Where do I go from here?	Pocahontas and Sequel
What a day in London	Pocahontas and Sequel
Wait until he sees you	Pocahontas and Sequel
Where do I go from here? (Reprise)	Pocahontas and Sequel
Honor to Us All	Mulan and Sequel
Reflection	Mulan and Sequel
I'll Make a Man Out of You	Mulan and Sequel
A Girl Worth Fighting For	Mulan and Sequel
True To Your Heart	Mulan and Sequel
Lesson Number One	Mulan and Sequel
I Wanna Be Like Other Girls	Mulan and Sequel
Hail to the Princess Aurora	Sleeping Beauty
The Gifts of Beauty and Song	Sleeping Beauty
I Wonder	Sleeping Beauty
Once Upon a Dream	Sleeping Beauty
Skumps	Sleeping Beauty
Sleeping Beauty (song)	Sleeping Beauty
Poor Aurora	Sleeping Beauty
